12:12
128 128 128 128 128 128 128 128 128 128 128 128
128 0 20 0  0 0 0 0 0 0 0  128
128 0 0 0 0 0 0 128 0 0 0  128
128 0 0 0 0 0 0 0 0 0 0  128
86 0 86 0 86 0 86 128 86 86 86 128
128 86 0 86  0 86 0 128 86 0 86 128
128 0 86 0 86 0 0 128 86  0 86 128
128 0 0 0 0 0 0 0 0 0 0  128
128 0 0 0 0 0 0 0 0 0 0  128
128 0 0 0 0 0 0 0 0 0 0  128
128 0 0 0 0 0 0 0 0 0 0  128
128 128 128 128 128 128 128 128 128 128 128 128
