12:12
18 0 52 17 18 0 18 18 18 18 18 18
18 0 0 17 18 0 0 0 0 0 0 0
18 0 0 17 17 0 0 0 0 0 0 0
17 0 0 0 0 0 0 0 0 0 0 0
0 0 18 17 17 0 0 18 0 0 0 0
18 0 18 17 0 0 0 32 32 32 32 32
18 0 18 17 0 32 0 0 0 0 32 32
32 0 18 17 0 0 0 0 0 0 0 32
87 0 0 17 0 0 0 0 17 0 0 0
18 17 0 17 0 0 0 0 17 0 0 0
32 17 0 17 0 0 0 0 0 0 0 0
0 0 0 17 0 0 18 0 18 51 0 0
