12:12
0 53 0 17 18 32 0 0 0 0 87 17
0 0 0 17 18 32 0 0 0 0 17 17
17 0 0 17 17 0 0 0 0 17 0 0
17 0 0 17 0 0 0 0 0 17 0 32
0 0 18 17 17 0 0 17 0 0 32 0
18 0 18 17 0 17 17 0 0 0 32 0
18 0 18 17 0 32 17 0 0 0 32 32
32 0 18 0 18 0 0 18 0 0 0 0
0 0 0 0 0 0 0 0 18 0 0 0
18 17 0 0 18 0 0 0 18 0 0 0
32 17 0 17 0 0 0 0 32 32 0 0
0 0 0 17 18 0 18 0 18 0 54 0
