12:12
57 0 0 17 18 0 0 0 87 0 0 0
0 0 17 17 18 0 0 0 0 0 0 0
0 0 17 17 32 32 32 32 18 32 32 18
17 0 17 17 18 32 18 32 18 0 18 18
0 0 17 17 17 0 0 18 17 0 0 0
18 0 17 17 0 0 18 17 0 0 32 32
18 0 17 17 0 32 17 17 17 0 32 32
32 0 17 17 18 0 17 0 17 0 0 32
0 0 17 17 0 0 17 0 17 0 0 0
0 17 17 0 18 0 17 0 17 0 0 0
32 17 0 0 0 0 17 0 17 0 0 0
0 0 0 17 0 17 18 0 18 0 58 0
