12:12
0 0 17 18 18 18 18 18 18 18 18 18
32 0 17 0 0 18 32 18 87 18 0 17
18 0 17 0 0 18 0 18 0 0 0 17
32 0 17 0 0 0 0 0 0 0 0 17
18 0 17 0 0 0 17 0 0 0 0 0
0 0 17 0 0 17 17 0 0 32 32 0
0 0 18 0 0 0 0 0 0 0 32 0
0 0 18 0 0 0 0 0 0 0 0 0
17 0 18 0 0 17 17 17 17 0 0 0
17 0 17 32 0 0 0 0 17 0 0 0
17 0 0 32 0 0 0 0 17 0 0 0
17 17 17 32 0 0 18 0 17 0 50 18
